xxxxxxxxxx
x........x
x........x
x....x...x
x.x......x
x........x
x....x...x
x.x......x
x........x
xxxxxxxxxx